10 10
00000000@0
0100111100
0000111100
0110111100
0110111100
0000000000
0011100100
0011100000
0011101000
0000000000
