10 10
00@0000000
0100333300
0000000000
0110000000
0110000000
0000000000
0033001000
0030000000
0033301000
0000000000
