10 10
1111111111
1@00000020
1011000010
1000000010
1000001110
1211000010
1011000110
1111111110
0000000000
0000000000
